 	第一天 
	install		安装
	uninstall	卸载
	keyboard	键盘
	monitor		显示器
	setup		设置
	exit		退出
	edit		编辑
	copy		复制
	cut		剪切
	paste		黏贴
第二天
	delete		删除
	select		选择
	find		查找	
	select all	全选
	replace		替换
	undo		撤销
	redo		重做
	program		程序
	license		许可证
	back		返回/后退
第三天
	next		下一步
	request		请求
	response	响应
	static		静态
	listen		听
	finish		结束
	folder		文件夹
	release		发布
	data base	数据库
	insert		插入
第四天
	update		更新
	config		配置
	common		共同
	short cut	快捷方式
	exception	异常
	debug		调试
	previous	前一个
	column		列
	row		行
第五天
	restart		重新启动
	start		开始
	stop		停止
	scale		比例
	interface	界面
	access		访问
	manual		手册
	active		激活
	computer	计算机
	language	语言
	menu		菜单
第六天
	page		页
	template	模板
	code		代码
	print		打印
	full screen	全屏
	final		最终
	general		一般
	connect		连接
	fetch		取来
	extension	扩展
第七天
	improvement	改进
	act		行动
	client		客户
	tool		工具
	paragraph	段落
	execute		执行
	save		保存
	browser		浏览器
	protocol	协议
	webpage		网页

		fixed 确定
		form feed 换页
		has been 已经
		topic 主题
		conventional 常规的
		ncorrect 不正确的
		indicate 表示
		invalid 无效的
		largest 最大的
		130.info  信息